SJSSSSSSPS
SSSSSSPPPS
SPPSSSSSPS
SSSSSSSSES
PPPPPPSSSS
