SJSSSSSSP
SSSSSSPPP
SPPSSSSSP
SSPESSSSP
SSSSSSSSS