SJSSSPSSPS
SSTSSPPSSS
SPPSSSSSPS
SSETSSSSES
PPPPPPSSES