SJSSSPSSPS
SSSSSPPSSS
SPPSSSSSPS
SSESSSSSES
PPPPPPSSES