SJSSSSSSPSSSPPPPP
SSSSSSPPPSSSSSSSS
SPPSSSSSPSSSPSPSS
SSPSSSSSPSSSPPPSS
SSSSSSSSSSSSPPPSS
PPPPPPSSSSSSESSSS
PPPPPPSSSSSSSSSSS
PPPPPPSSSSSSSSSSS
PPPPPPSSSSSSSSSSS